1111111111111



1P00000000001
1111111111111