1111111111111
1P00000000001
1000011111C01
101C000000001
1011100110001
100C0001C0111
10000111000E1
1111111111111