11111111111
1E00000C001
1010C101001
10100100101
1P0000000C1
11111111111