1111111111111
1E001C0000C01
1110111011111
1P101C1010001
10000000001C1
1111111111111