1111111111111
1000CC00EP101
100CCC0111001
10100C1010001
10000000001C1
1111111111111