1111111111111
1PE000C100001
1110C10100001
1110010010001
100000000C001
1111111111111